111111111111111111111111111111111111
100000000000000000000000000000010001
100000111111111110001100000000010001
100000100000000000001100011100000001
100000100000000000000000001000001001
101100100000111111100010000000011101
10010010000010p010100011000100000001
101100100000004010000000000111100111
100000111111111110001110000000000001
100000000000000000000000000000000111
100000000000100000001111111110000001
11000100011111100100100g000010001001
11111100001000000100100ggg0010011001
100000000000000011001111211110010001
100000000000000001001000000000000101
100111110000001000001000000000000101
100100010011111000000000011110000001
100000000010000000000000000100111101
100001000000000000000000000000010001
111111111111111111111111111111111111

0 food
1 wall
2 gate          (only0one)
p pacman        (only0one)
g ghost
3 blank
4 power0ball
