111111111111111111111111111111111111
140000000000000000000000000000000041
101111110111111111111111111011111101
100000010000000000000000000010000001
101111010100000004000000001010111101
100001010105555555555500001010100001
101001010105000000000500001010100101
101001010105000000000000001010100101
101001010105000000000000001010100101
101000000005000000000000000000000101
101p00000005000000555555500000000101
101001010105000000500500501010100101
101001010105000000000500001010100101
101001010105000000000500001010100101
100001010105555555555500001010100001
101111010100000000000000001010111101
100000010000000000000000000010000001
101111110111111112211111111011111101
1400000000000001gggg1000000000000041
111111111111111111111111111111111111

0 food
1 wall
2 gate          (only one)
p pacman        (only one)
g ghost
3 blank
4 power ball
5 G power
